111111111111111
100020002220001
101212121212101 
102002200022001
101212121012101
100022220002001
101212121212101 
102222222220021
101012121210121
120222222222221
101212101212101 
102002222000221
101210101210101 
100002222002001
111111111111111